################
#PF 2        D #
# # #  #M#  #  #
#  #  ###  # 2 #
#  #    # D    #
# 0#### ########
#    D      D  F
################
