#############
#         LP#
#          L#
#           #
#           #
#           #
#           #
#           F
#############