#############
#M#  # #    #
# # D    # ##
#   ## ###  #
#    # PF## #
##D #    #  #
#  # ##### ##
##       D  F
#############