#############
#M#  # #    #
# # D    # ##
#   ## ###  #
#    # P ## #
##D #    #  #
#  # ##### ##
##       D F#
#############